15 15
1:13,4:11,1:13,1:13,1:13,1:13,1:13,1:13,1:13,1:13,1:13,1:13,1:13,1:13,1:13
1:13,3:11,1:13,1:13,1:13,1:13,1:13,1:13,1:13,1:13,1:13,1:13,1:13,1:13,1:13
1:13,3:11,1:13,1:13,1:13,1:13,1:13,1:13,1:13,1:13,1:13,1:13,1:13,1:13,1:13
1:13,3:26,3:15,3:15,3:15,3:15,3:15,3:15,3:15,3:15,3:15,3:15,3:15,3:23,1:13
1:13,1:13,1:13,1:13,1:13,1:13,1:13,1:13,1:13,1:13,1:13,1:13,1:13,3:11,1:13
1:13,3:22,3:23,3:22,3:23,3:22,3:23,3:22,3:23,3:22,3:23,1:13,1:13,3:11,1:13
1:13,3:11,3:26,3:27,3:26,3:27,3:26,3:27,3:26,3:27,3:26,3:15,3:15,3:27,1:13
1:13,3:11,1:13,1:13,1:13,1:13,1:13,1:13,1:13,1:13,1:13,1:13,1:13,1:13,1:13
1:13,3:11,1:13,1:13,1:13,1:13,1:13,1:13,1:13,1:13,1:13,1:13,1:13,1:13,1:13
1:13,3:26,3:15,3:15,3:15,3:15,3:15,3:15,3:15,3:15,3:15,3:15,3:15,3:23,1:13
1:13,1:13,1:13,1:13,1:13,1:13,1:13,1:13,1:13,1:13,1:13,1:13,1:13,3:11,1:13
1:13,1:13,1:13,1:13,1:13,1:13,1:13,1:13,1:13,1:13,1:13,1:13,1:13,3:11,1:13
1:13,1:13,1:13,1:13,1:13,1:13,1:13,1:13,1:13,1:13,1:13,1:13,1:13,3:11,1:13
1:13,1:13,1:13,1:13,1:13,1:13,1:13,1:13,1:13,1:13,1:13,1:13,1:13,3:11,1:13
1:13,1:13,1:13,1:13,1:13,1:13,1:13,1:13,1:13,1:13,1:13,1:13,1:13,5:11,1:13
